auth <Name> <Level>	Admin	(SetAuthCommand)
auth <Name>	Admin	(GetAuthCommand)
define <Term>	All	(DefineCommand)
kill <Name>	Admin	(KillCommand)
killid <PlayerId>	Admin	(KillIdCommand)
ping 	All	(PingSelfCommand)
ping <Name>	All	(PingCommand)
p|position 	Trusted	(PositionSelfCommand)
p|position <Name>	Trusted	(PositionCommand)
quote 	All	(QuoteCommand)
quote <Category>	All	(QuoteCategoryCommand)
repair|heal 	Admin	(RepairAllCommand)
repair|heal <Name>	Admin	(RepairCommand)
autorepair|autoheal 	Admin	(AutoRepairCommand)
stop 	Admin	(StopCommand)
startstream 	God	(StartStreamCommand)
stopstream|kickbot 	God	(StopStreamCommand)
time 	All	(TimeCommand)
follow <Stream>	Trusted	(TwitterFollowCommand)
unfollow 	Trusted	(TwitterUnfollowCommand)
blur <Name>	God	(BlurCommand)
crash 	Admin	(CrashCommand)
d|dance 	Admin	(DanceAllCommand)
d|dance <Name>	Admin	(DanceCommand)
leave <Minutes>	All	(LeaveCommand)
calladmin <Reason>	All	(CallAdminCommand)
starteventrecorder 	God	(StartEventRecordingCommand)
stopeventrecorder 	God	(StopEventRecordingCommand)
flip <Name>	Admin	(FlipCommand)
freeze 	God	(FreezeAllCommand)
freeze <Name>	God	(FreezeCommand)
g|gravity 	Admin	(GravityDefaultCommand)
g|gravity <Value>	Admin	(GravityCommand)
pad 	Admin	(PadCommand)
autopad 	All	(AutoPadAllCommand)
autopad <Name>	All	(AutoPadCommand)
sw|switch 	Admin	(SwitchAllCommand)
sw|switch <Rounds>	Admin	(SwitchLaterCommand)
sw|switch <Name>	Admin	(SwitchCommand)
switchid <PlayerId>	Admin	(SwitchIdCommand)
nasa <Value>	Admin	(NasaCommand)
mg <Value>	Admin	(HeliMgCommand)
noclip <Name> <Value>	God	(NoclipCommand)
stalk <Name>	God	(StalkCommand)
2v2 <Value>	God	(Toggle2v2Command)
tv|tvmissile 	SuperAdmin	(GetTvMissileValuesCommand)
tv|tvmissile <Name> <Value>	SuperAdmin	(SetTvMissileValueCommand)
tv|tvmissile <Type>	SuperAdmin	(SetTvMissileTypeCommand)
tvlog| <Name>	SuperAdmin	(ToggleTvLogCommand)
nofences 	Admin	(NoFencesCommand)
jail <Name>	Admin	(JailPlayerCommand)
free <Name>	Admin	(FreePlayerCommand)
load|mapload <Name>	Admin	(MapLoadCommand)
save|mapsave <Name>	Admin	(MapSaveCommand)
o|mapobject <Template>	Admin	(MapObjectCommand)
clear|mapclear 	Admin	(MapClearCommand)
undo|mapundo <Count>	Admin	(MapUndoCommand)
record 	Admin	(RecordCommand)
playback 	Admin	(PlaybackCommand)
loop 	Admin	(LoopCommand)
r|rank <Name> <Rank>	Admin	(RankCommand)
score <Name> <TotalScore> <TeamScore> <Kills> <Deaths>	Admin	(ScoreCommand)
score <Reset>	Admin	(ScoreResetCommand)
mod <Name> <Value>	God	(ScriptModCommand)
tp|teleport <Name> <Location>	Admin	(TeleportLocationCommand)
tp|teleport <Name> <X> <Y> <Altitude>	Admin	(TeleportCoordinatesCommand)
interval|timerinterval <Value>	Admin	(TimerIntervalCommand)
